Melody - AYABIE
Each Other's way ~Tabi no Tachuu~ - Exile
Connect - CLaris
Answer Is Near - ONE OK ROCK
Kawaranu Omoi - clear
Okubyou no OOkami - Hilchryme
Yakusoku - Suga Shikao
Blue Bird -Kobukoru
Haru n Natara - miwa
Nanika Hitotsu feat. JAY'ED & Wakadanna - JAMOSA
Aoi Bench - Tegomass
Sotsygyou - Sata Andagi
Tomodachi no Uta - BUMP OF CHICKEN
Lotus - ARASHI

Misery - Kuroyume
Ima no Kimi wo Wasurenai - Naoto Inti Raymi
Monochrome - Aoi & Ryohei incl. Ayabie Megamusso
Distance - Kana Nishino
Idome - KREVA
Magia - Kalafina
LOVE & PEACE - Yoshii Kazuya
Daiji na Koto - AAA
DIS IT - LOW IQ 01

Kono Yoru wo Tomete yo - JUJU
Hito tono Kyori no Harikata - plenty
Ryuusei - Kobukuro

Ballad/Kimi to Tsukuru Mirai - Ketsumeishi
Simple is Best - Yaida Hitomi
Konpeki no Soujin - Onmyouza
with you feat.Me - BACK-ON
Mukei Spirit - Shibasaki Kou

merry-go-round - Chemistry
Kudaranai no Naka ni - Hoshino Gen
Kizuna - Kitano Kie
Memories Last - Kurosaki Maon
EXIT - Porno Grafitti
Eternal - Akanishi Jin

Sign - SIGN

Saigo no Koi - HIROKO

1/3 no Junjou no Kanjou - FLOW
Sakurane - PIKO

1000 Mankai no Kiss - Kuraki Mai
By your side feat.Nishino Kana - WISE
Philia - Versailles
ONE - D=OUT
Yuushatachi - Kato Miliyah
Rookie - Sakanaction